Level 3
 #####
##   ###
# o o  #
# @  # ##
#  @    A#
### #   #
  #   ###
  #####