Level 2
######
#    #
# @  ##
# o   #
### #####
#      A#
###   @ #
  #o  ###
  #####